1 1 1 1 1 1
1 c 0 c 1 1
1 0 1 0 1 1 
1 c p c 1 1
1 1 1 1 1 1