1 1 1 1 1 1
1 1 p 0 1 1
1 1 1 c 1 1 
1 1 1 1 1 1
1 1 1 1 1 1